andmebaas - database(БД)
andmebaasihaldur - админ БД
andmebaasi haldamise tarkvara - СУБД - система управления БД
kirje - записывать
väli - поле
tabel - таблица
päring - запрос 
veerg - графа
rida - строка
seos/seosed - связь/связи 
piirangud - ограничения / PRIMARY KEY, FOREIGN KEY, UNIQUE, NOT NULL
primaarvõti - первичный ключ
andmemudel - модель данных
varukoopia - резервная копия
kasutusjuhend - Руководство пользователя
turvalisus - безопасность
kättesaadavus - Доступность
andmete õigsus - достоверность данных
sisestusvorm - форма ввода

--------------------------------------------------------

näide - пример
näidis - образец
sõltuvus - зависимость (таблиц между собой)
seadistus - настройка
paigaldus - установка
hooldus - обслуживание
andmemudel - модель данных
lisamine - добавление 
kustutamine - удаление 
uuendamine - обновление 
sorteerimine - сортировка 
pärimine - запрашивание, опрос
kasutaja - пользователь
kasutajate õigused - права пользователей
haldamine - администрирование